1111
1E11
1111
1001
1001
10C1
1P01
1111
