1111111
1C10001
1E10001
1P000C1
1111111
