1111111111111
1C110000000C1
1000011111011
1P0011E00*0C1
1111111111111
1111111111111
1C110000000C1
1000011111011
1P0011E00*0C1
1111111111111
